10. Design Patterns - GOF.pdf
11. The Mythical Man Month - Frederick Brooks.pdf
12. Working Effectively With Legacy Code - Michael Feathers.pdf
1. Code Complete 2 - Steve McConnell.pdf
2. The Pragmatic Programmer - Andrew Hunt, David Thomas.pdf
3. Structure and Interpretation of Computer Programs - Harold Abelson, Gerald Sussman.pdf
4. Introduction to Algorithms - CLRS.pdf
5. Clean Code - Robert Martin.pdf
6. Refactoring -  Martin Fowler.pdf
8. Code - Charles Petzold.pdf
9. Programming Pearls - Jon Bentley.pdf
1 Data Structure and Algorithmic Thinking with Python - Narasimha Karumanchi.pdf
Algorithm Design - Jon Kleinberg, Éva Tardos.pdf
Computer Algorithms - Ellis Horowitz, Sartaj Sahni, Sanguthevar Rajasekaran.pdf
Natural Language Processing with Python - Steven Bird, Ewan Klein, Edward Loper.pdf
Natural Language Processing with TensorFlow - Thushan Ganegedara.pdf
Speech and Language Processing - Daniel Jurafsky, James Martin.pdf
1 The Linux Command Line - William Shots.pdf
2 Pro Git - Scott Chacon, Ben Straub.pdf
Computer Network - James Kurose, Keith Ross .pdf
Introduction to Information Retrival - Christopher D. Manning, Prabhakar Raghavan, Hinrich Schütze.pdf
0 Minning of Massive Datasets - Jure Leskovec, Anand Rajaraman, Jeffrey Ullman.pdf
1 Hands on Machine Learning: Scikit-Learn_Keras_TensorFlow - Aurélien Géron.pdf
Building Machine Learning Powered Applications - Emmanuel Ameisen.pdf
Designing Data Intensive Applications - Martin Kleppmann.pdf
Dive into Deep Learning - Aston Zhang, Zachary C. Lipton, Mu Li, Alexander J. Smola.pdf
Graph Algorithms in Apache Spark_Neo4j - Mark Needham, Amy Hodler.pdf
Introduction to Machine Learning with Python - Andreas C. Mueller, Sarah Guido .pdf
Practical Machine Learning with Python - Dipanjan Sarkar, Raghav Bali, Tushar Sharma.pdf
Real-World Machine Learning - Henry Brink, Joseph Richards, Mark Fetherolf.pdf
The Hundred Page Machine Learning Book - Andriy Burkov.pdf
High Output Management - Andrew Grove.pdf
The Five Dysfunctions of a Team - Patrick Lencioni.pdf
The Harvard Business Review manager’s handbook.pdf
The Manager’s Path - Camille Fournier.pdf
1 CTCI - Gayle Mcdowell.pdf
2 EPI java - Anand Aziz, Tsung Lee, Amit Prakash.pdf
Cracking The PM Interview.pdf
Cracking The Tech Career.pdf
EPI c++.pdf
PIE - John Mongan, Eric Giguère, Noah Kindler.pdf
Mastering C# and .NET Framework - Marino Posadas.pdf
Introduction to C++ for Financial Engineers - Daniel Duffy.pdf
The C++ Programming Language - Bjarne Stroustrup.pdf
Go In Practice - Matt Butcher, Matt Farina.pdf
Introducing Go - Caleb Doxsey.pdf
Machine Learning With Go - Daniel Whitenack.pdf
The Go Programming Language - Alan Donovan, Brian Kernighan.pdf
Effective Java - Joshua Bloch.pdf
Head First Java - Kathy Sierra and Bert Bates.pdf
Learn Java in One Day and Learn It Well - Jamie Chan.pdf
1 Hands-On RESTful Python Web Services Develop RESTful web services - Gaston C. Hillar.pdf
Designing Microservices with Django - Akos Hochrein.pdf
Django: Web Development with Python - Samuel Dauzon, Aidas Bendoraitis, Arun Ravindran .pdf
Flask By Example - Gareth Dwyer.pdf
Flask Web Development - Miguel Grinberg.pdf
Pro Python System Administration - Rytis Sileika.pdf
The Definitive Guide to Django -  Adrian Holovaty , Jacob Kaplan-Moss.pdf
Think Python - Allen Downey.pdf
Building Microservices  - Sam Newman.pdf
Cloud Native DevOps with Kubernetes - John Arundel, Justin Domingus.pdf
Distributed Systems for practitioners - Dimos Raptis.pdf
Domain-Driven Design - Eric Evans.pdf
Monolith to Microservices - Sam Newman.pdf
Patterns of Enterprise Application Architecture - Martin Fowler.pdf
Unix for the beginning mage - Joe Topjian.pdf
A Little History of Economics - Niall Kishtainy.pdf
Artificial Intelligence in Practice - Bernard Marr.pdf
Big Data - Bernard Marr.pdf
Big Data Case Study - Bernard Marr.pdf
New Thinking (Cold Fusion) - Dagogo Altraide.pdf
Sapiens - Yuval Harari.pdf
Tech Trends in Practice - Bernard Marr.pdf
The Black Box Society -  Frank Pasquale.pdf
The Black Swan - Nassim Taleb.pdf
The Innovators - Walter Isaacson.pdf
The Selfish Gene - Richard Dawkins.pdf
Thinking, Fast and Slow - Daniel Kahneman.pdf
Understanding the Digital World - Brian Kernighan.pdf
